NO ./texture/north
SO ./texture/north
WE ./texture/north
EA ./texture/north
C 225,30,0
F 220,100,126



1
1111111
1000101
1000001
1000001
1111001
1000001
1000001
1000001
1111111
      1