NO ./texture/north
SO ./texture/north
WE ./texture/north
EA ./texture/north
C 225,30,0
F 220,100,126

1111
10  1     1
1111   1
1111111  11111
 1100011100N1
100000000111
11000000001
100000001111
1111000000001
1000000111111
1  000000001
1111111111111
1
    111    1
    101
     1