NO ./texture/north
SO ./texture/north
WE ./texture/north
EA ./texture/north
C 225,255,255
F 100,100,100

11111111
1N000001
11111111
1111