NO ./texture/north
SO ./texture/south
WE ./texture/west
EA ./texture/east
C 22,23,124
F 126,015,024

11111111111111
10000000000001
10000000000001
10000000000001
1000000N000001
10000000000001
10000000000001
10000000000001
10000000000001
11111111111111