NO ./texture/lilwater.xpm

EA ./texture/lilgrass.xpm

WE ./texture/lilsand.xpm

SO  ./texture/lilbrick.xpm

F   102,255,153
C   79,199,255

1111111111111111111
10010010010010010011111
1001001001001001001
10010010010010010011111
1001001000001001001
1N0000000000000000111111
100001111111100000101111  1
1111111111111111111111   101
1111000000000001111       1
1000000101010000001
1111111111111111111