NO ./texture/north
SO ./texture/north
WE ./texture/north
EA ./texture/north
C 225,30,0
F 220,100,126





111111011111111111111111111111
111110101111111111111111111111
100000000011000000000000111111
101100000111000000000000111111
100100000000000000000000111111
111111111011000001110000000000
100000000011000001110111111111
111101111111110111000000100011
111101111111110111010100100011
110000001101010111000000100011
100000000000000011000000100011
100000000000000011010100100011
11000001110101011111011110N011
111101111111010111011110100011
111111111111111111111111111111